10 10 10 10 00 10 10 10 10
10 20 20 10 00 10 20 20 10
10 20 20 10 00 10 20 20 10
10 10 10 10 10 10 10 10 10
00 00 00 20 20 20 00 00 00
10 10 10 10 10 10 10 10 10
10 20 20 10 00 10 20 20 10
10 20 20 10 00 10 20 20 10
10 10 10 10 00 10 10 10 10